000000000000000000000-
111000110011100100111-
100101001010010100100-
111101001011110100111-
100101001010100100001-
111000110010010100111-
000000000000000000000-
000000000000000000000